0000000111
2222000100
1001000200
1001000101
1211000101
0001111201
0001000001
0001122222
